$ANSIBLE_VAULT;1.1;AES256
62633435326330353435383130316265306630653434333136313461663432303565613639313464
6231303232323036343765373234346538323334386533650a653737393136643966353735316463
32383437373863336366316239393565656363363264376132643834303763393338646665343834
3164623265373265350a316462623732363737313135323331353436636164336137313166393538
64646565353361633635613962353138303261363032343636373835323634663138613262653563
66383930666166643235343265393131626433313934393633653332323464333239373933653539
37643963663964313466643736373763653331336136363364616166623634316364333136356337
32633061353866323466303730633831326234373134356462383965653036326134393535663939
62363935363233303263336335656239363933386363653162353332303238366565326130393266
61343434303932366430373166623735373637306432666336343539613463653538636431626466
373630316361386362393839306236656330
