$ANSIBLE_VAULT;1.1;AES256
65323364636431313463643338363430333037373166613834306339636233323635336462363863
6636316534383265386534326561386539363536643966330a363532663231646537393533333765
34626132373637643830646639343932366263326337656135303733656538333935626235393231
6662396130336165390a656537346530363438343534666636333461386262393863633039303663
65646532656330653739616333663662393264336636623231643130646537633535343730663865
30396461653232626165376638656339396539666633306536373133306237303034613833636662
30643230313734366662363863376661653032343763333861646562666565656639323966343730
34396562336336356562396561656437356465333236303864336666306661343133653539383631
61346561653165663562616566306162666638306132643939343132386661336661356561393732
34386163666239646237646264383432636339383635623861613836613433323839663264616361
62646236383033626431323763326338343236333463376161396230643331656437663539656430
36376361666462316361393362316336363239656130353633336563303165373330396663363038
38353535323766623139386536343235663635356639363932376137643135313961343263386533
62333036356637376234376536663162343162373238383965633962663839383435666261626162
63626139643538356139376532646136616432396361313431303837373138316333313033373664
66353961383765666162373361663430663037326332346334303266653831613731323438303636
32393635656366373737316333313061636432613764626361653365336437643064323666336263
33653434653564373535323637626139653835623633316234633364346535303739663731343837
32306339613633383832356262356338306637333838646165353632626137363336323833396134
30636330616133333364353261303466623839623666316238336637303964393733313266636666
35616465353162323035373439616337656437623463393038353639633734386537383638623338
31303138623431356261346138653339383363386663356238396533383333633666346439616133
65346530396638386332333735323937666636363763346565383537346263303834643233656666
39386366333439316339303532393938303030386237363362393336393638663165376161613130
65623363643763323634383863313631626137623236383338653731643462373962383336306134
63303338663536346330653261653837393138386130353365613565303133373537346364373030
32333561396334343631303232623166643736323930373461613530373034356531346365623036
63636662353031343765666139313634326134313439663939633634333066646630303364393565
34373837346263353061316535633435383866656436643163616433376434366138626466376262
39303739306239663564316534306132326236336364383435626439316236633934643831653830
34333634326135393831373431336262336465643937643462633934396638623033626662323135
32623632373236353039663464633631616534363737383635356335633766356566366231613430
63313434663039303339366633353665393836666538326538333865633533326638343061323461
32353937616533653061313265313333316339643834373563313332383939616133383961666265
36366438623135383336623133313764326533383761313335353934393837316364613931383164
63633563633039646335373666363038303166646164633533393437386139313931626231343432
34633731393732656632653363303535633937346432653762356331363234313936353562663130
31303864336265383030666162306136323836613061643864303461353530366165393864336534
31663035653365323661303863626236633234336666653339336631366132333639656661346564
66393061633839356539613438353735613736316430653136376564343731396237623737626530
34383532373931633062333837356566376330656262333837633464393164333966303335643561
37376666343534633163363038323035643330373861303363306336666437376263356139303239
36376436333465343930643338353839666230666234356562616230313034653331303139643436
32373631643139653332373930646433626665616465623565316263396134383637346539343132
63366266383061643365663036633537343537363662363130383535336537306630323236303736
30643534383161303231356662363932643335363532663032333161353939646530633162643232
30636438326264663334303933313061396361306430633066633861346533356437353830356232
64646136623435363366656534393464663939313966336435363535626338326339356630386564
65333965383662393837363065363635343666376132613535333531333634626263653038356134
33353237323261643237633039326635653736316165623037633764613135643464363963623061
32346136623166306635336262386432366334353930386439303065393833393735323565643531
32306138626131623435316464353936393538323962363136326562656463663439616335376463
31643935313839383738346330393834636434653139666130343532306134376432333232666564
32633865336362626532313532393034633833643031343734373062656237363666623930663261
356634643465383264373538633935653333
